[
    "IIAFA_CCCCCCCCJBIAAEGCCEAAAEACCAAAAAACCAGADDDCCAEAEAGCCAGAAEGCCCCCCCCC",
    "IIAEA_CCCCCCCCJIAEEBBCCAAEEGBCCDDDDAACCGGBEBBCCAADDDACCBEAAAGCCCCCCCCC",
    "IIAFA_CCCCCCCCJIADBBNCCAADGBECCAEDAAGCCAEEGBECCAAGAAACCAAABBGCCCCCCCCC",
    "IIAEA_CCCCCCCCJIDEEEACCADGGEACCADDDDACCAEAAEACCAEEAEACCGEEGEECCCCCCCCC",
    "IIAFA_CCCCCCCCJIAEBBACCDDDEBACCEEEAAACCGGEAAACCEGEAAACCGGEAAACCCCCCCCC",
    "IIACA_CCCCCCCCJIAABBBCCAAABNGCCAAADDDCCAAABBBCCAAABNGCCAAADDDCCCCCCCCC",
    "IIAJA_CCCCCCCCJIAEDBBCCAAADQBCCAAADAACCAAAAEACCEAAAAACCAAAAAACCCCCCCCC",
    "IIADA_CCCCCCCCJIAAAEACCDDAAAACCGDAAAACCGDAAAACCEDDDDACCGBNBBBCCCCCCCCC",
    "IIABA_CCCCCCCCJIAAAAACCADAAAACCADAAAACCADDDDDCCADBBBNCCAANBBGCCCCCCCCC",
    "IIAMA_CCCCCCCCJBBIADBCCEEAADQCCGAAADACCAAEGAACCAAAAAACCAAANBGCCCCCCCCC"
]
